연월,자치구명,65~69세,70~74세,75~79세,7세미만,80~89세,90세이상,합계,점수
201601,강남구,906,876,665,390,632,138,3607,3
201601,강동구,637,626,585,254,576,109,2787,2
201601,강북구,1004,1203,982,354,869,124,4536,4
201601,강서구,1384,1490,1420,370,1486,264,6414,6
201601,관악구,891,956,874,304,820,115,3960,3
201601,광진구,443,478,397,143,439,60,1960,1
201601,구로구,528,662,671,282,556,77,2776,2
201601,금천구,633,772,625,234,626,85,2975,2
201601,노원구,1667,1921,1640,495,1657,307,7687,7
201601,도봉구,556,668,631,213,626,96,2790,2
201601,동대문구,968,1077,903,202,715,104,3969,3
201601,동작구,528,625,568,238,552,98,2609,2
201601,마포구,559,679,540,256,558,89,2681,2
201601,서대문구,464,553,531,540,503,68,2659,2
201601,서초구,275,344,246,182,291,46,1384,1
201601,성동구,492,569,514,135,465,57,2232,1
201601,성북구,862,988,883,354,788,134,4009,3
201601,송파구,571,576,477,196,500,92,2412,2
201601,양천구,633,706,687,260,629,93,3008,2
201601,영등포구,805,748,611,182,599,109,3054,2
201601,용산구,531,534,496,153,384,68,2166,1
201601,은평구,1283,1303,1091,442,1013,136,5268,5
201601,종로구,359,424,303,40,302,78,1506,1
201601,중구,368,379,327,75,342,35,1526,1
201601,중랑구,1015,1044,864,347,982,180,4432,4
201602,강남구,908,884,668,378,645,137,3620,3
201602,강동구,632,626,593,256,577,109,2793,2
201602,강북구,1021,1203,978,362,880,125,4569,4
201602,강서구,1387,1500,1429,360,1493,264,6433,6
201602,관악구,913,942,887,317,832,120,4011,3
201602,광진구,453,475,408,142,441,59,1978,1
201602,구로구,546,662,671,279,578,77,2813,2
201602,금천구,639,777,630,240,627,80,2993,2
201602,노원구,1668,1899,1660,491,1674,310,7702,7
201602,도봉구,564,673,654,221,632,95,2839,2
201602,동대문구,976,1075,911,203,725,103,3993,3
201602,동작구,526,633,577,245,552,102,2635,2
201602,마포구,563,677,536,238,567,92,2673,2
201602,서대문구,467,556,533,563,518,69,2706,2
201602,서초구,274,346,254,184,291,48,1397,1
201602,성동구,497,568,511,134,475,57,2242,1
201602,성북구,875,987,891,352,794,131,4030,3
201602,송파구,572,569,486,194,507,92,2420,2
201602,양천구,633,715,688,260,628,96,3020,2
201602,영등포구,809,739,616,185,599,109,3057,2
201602,용산구,529,533,501,151,390,69,2173,1
201602,은평구,1292,1298,1099,440,1052,137,5318,5
201602,종로구,356,418,302,35,304,81,1496,1
201602,중구,366,378,329,77,345,35,1530,1
201602,중랑구,1027,1040,880,345,989,185,4466,4
201603,강남구,915,884,679,407,654,131,3670,3
201603,강동구,645,625,604,262,595,110,2841,2
201603,강북구,1014,1206,996,358,894,127,4595,4
201603,강서구,1389,1491,1443,368,1499,267,6457,6
201603,관악구,911,944,900,317,826,128,4026,3
201603,광진구,446,475,411,143,447,62,1984,1
201603,구로구,555,661,673,282,583,77,2831,2
201603,금천구,642,775,628,252,633,82,3012,2
201603,노원구,1671,1886,1667,496,1688,306,7714,7
201603,도봉구,573,674,654,229,639,100,2869,2
201603,동대문구,973,1076,902,203,734,103,3991,3
201603,동작구,531,639,571,243,563,105,2652,2
201603,마포구,564,682,538,240,574,93,2691,2
201603,서대문구,476,555,538,504,530,67,2670,2
201603,서초구,275,340,261,181,296,47,1400,1
201603,성동구,505,571,513,137,476,61,2263,1
201603,성북구,882,976,895,363,809,129,4054,3
201603,송파구,586,576,490,206,510,93,2461,2
201603,양천구,629,716,687,272,640,94,3038,2
201603,영등포구,801,742,621,185,597,108,3054,2
201603,용산구,535,533,492,149,392,68,2169,1
201603,은평구,1288,1274,1093,446,1064,141,5306,5
201603,종로구,356,416,303,32,300,81,1488,1
201603,중구,381,375,334,80,351,35,1556,1
201603,중랑구,1036,1038,891,350,999,187,4501,4
201604,강남구,923,874,691,403,664,127,3682,3
201604,강동구,650,623,607,286,597,117,2880,2
201604,강북구,1028,1196,994,382,911,123,4634,4
201604,강서구,1394,1489,1445,370,1509,273,6480,6
201604,관악구,906,953,906,322,831,132,4050,3
201604,광진구,441,476,411,160,447,62,1997,1
201604,구로구,553,657,677,301,589,81,2858,2
201604,금천구,640,774,633,269,644,85,3045,2
201604,노원구,1646,1876,1670,515,1697,310,7714,7
201604,도봉구,581,683,658,245,639,100,2906,2
201604,동대문구,978,1069,906,218,735,97,4003,3
201604,동작구,537,638,571,257,570,103,2676,2
201604,마포구,562,676,540,250,578,92,2698,2
201604,서대문구,474,555,547,526,527,70,2699,2
201604,서초구,280,341,259,190,296,49,1415,1
201604,성동구,498,569,517,147,469,62,2262,1
201604,성북구,886,965,893,388,819,129,4080,3
201604,송파구,594,586,490,235,506,94,2505,2
201604,양천구,631,715,674,277,648,88,3033,2
201604,영등포구,796,747,612,195,594,107,3051,2
201604,용산구,536,529,502,154,391,69,2181,1
201604,은평구,1291,1277,1091,478,1068,148,5353,5
201604,종로구,356,420,309,38,296,83,1502,1
201604,중구,390,368,339,87,342,35,1561,1
201604,중랑구,1037,1037,898,398,1003,188,4561,4
201605,강남구,925,881,696,409,669,125,3705,3
201605,강동구,654,623,599,298,591,115,2880,2
201605,강북구,1023,1197,1004,390,915,127,4656,4
201605,강서구,1398,1482,1451,407,1523,267,6528,6
201605,관악구,892,948,896,330,824,131,4021,3
201605,광진구,441,473,412,171,446,62,2005,1
201605,구로구,567,651,681,311,586,84,2880,2
201605,금천구,640,765,638,273,639,82,3037,2
201605,노원구,1657,1844,1681,530,1701,316,7729,7
201605,도봉구,578,688,655,274,648,105,2948,2
201605,동대문구,962,1072,913,229,746,97,4019,3
201605,동작구,535,637,572,265,571,106,2686,2
201605,마포구,566,671,542,260,583,93,2715,2
201605,서대문구,470,558,540,543,521,70,2702,2
201605,서초구,281,333,261,198,294,48,1415,1
201605,성동구,502,562,522,159,468,66,2279,1
201605,성북구,877,962,897,397,830,129,4092,3
201605,송파구,585,594,488,234,504,94,2499,2
201605,양천구,634,719,675,288,646,92,3054,2
201605,영등포구,807,743,602,214,596,104,3066,2
201605,용산구,530,530,503,165,395,67,2190,1
201605,은평구,1261,1295,1091,487,1077,151,5362,5
201605,종로구,362,418,309,44,291,83,1507,1
201605,중구,387,365,343,89,336,38,1558,1
201605,중랑구,1044,1038,908,393,1008,190,4581,4
201606,강남구,907,877,691,406,663,125,3669,3
201606,강동구,664,638,599,307,586,109,2903,2
201606,강북구,1024,1190,1016,393,929,134,4686,4
201606,강서구,1407,1475,1474,397,1527,269,6549,6
201606,관악구,887,954,893,331,829,133,4027,3
201606,광진구,442,479,410,169,449,60,2009,1
201606,구로구,570,660,675,314,602,83,2904,2
201606,금천구,650,766,638,273,640,83,3050,2
201606,노원구,1659,1841,1692,528,1700,314,7734,7
201606,도봉구,587,689,666,273,652,105,2972,2
201606,동대문구,957,1072,915,227,752,94,4017,3
201606,동작구,536,642,578,274,575,109,2714,2
201606,마포구,568,667,546,264,578,91,2714,2
201606,서대문구,489,550,541,545,526,69,2720,2
201606,서초구,288,332,257,190,299,53,1419,1
201606,성동구,502,560,532,155,467,66,2282,1
201606,성북구,879,969,904,388,826,130,4096,3
201606,송파구,593,603,489,231,510,92,2518,2
201606,양천구,642,719,682,285,647,93,3068,2
201606,영등포구,801,728,599,209,600,101,3038,2
201606,용산구,524,531,494,163,405,66,2183,1
201606,은평구,1256,1290,1093,477,1088,154,5358,5
201606,종로구,365,415,312,42,292,84,1510,1
201606,중구,380,369,345,91,336,41,1562,1
201606,중랑구,1039,1044,923,379,1014,191,4590,4
201607,강남구,895,881,699,405,664,127,3671,3
201607,강동구,667,641,602,299,589,109,2907,2
201607,강북구,1029,1185,1023,380,948,134,4699,4
201607,강서구,1388,1480,1492,388,1536,270,6554,6
201607,관악구,894,955,902,324,826,132,4033,3
201607,광진구,446,480,414,160,451,63,2014,1
201607,구로구,563,666,674,310,601,86,2900,2
201607,금천구,655,763,639,276,646,89,3068,2
201607,노원구,1657,1833,1709,542,1710,315,7766,7
201607,도봉구,586,689,669,262,664,102,2972,2
201607,동대문구,954,1067,912,217,757,98,4005,3
201607,동작구,534,649,584,267,578,107,2719,2
201607,마포구,570,662,548,263,580,88,2711,2
201607,서대문구,487,550,545,552,529,69,2732,2
201607,서초구,287,337,253,185,302,53,1417,1
201607,성동구,504,559,540,154,461,70,2288,1
201607,성북구,880,965,915,382,822,132,4096,3
201607,송파구,597,610,489,223,511,93,2523,2
201607,양천구,647,713,684,273,652,92,3061,2
201607,영등포구,801,718,605,204,594,98,3020,2
201607,용산구,518,529,497,160,408,68,2180,1
201607,은평구,1260,1296,1102,463,1097,159,5377,5
201607,종로구,358,418,316,40,296,81,1509,1
201607,중구,377,373,345,88,337,42,1562,1
201607,중랑구,1031,1050,931,371,1013,195,4591,4
201608,강남구,893,893,697,412,664,125,3684,3
201608,강동구,663,649,612,288,587,108,2907,2
201608,강북구,1023,1188,1024,372,951,138,4696,4
201608,강서구,1384,1476,1500,408,1551,268,6587,6
201608,관악구,897,956,913,322,835,131,4054,3
201608,광진구,442,483,417,162,447,64,2015,1
201608,구로구,567,663,679,294,597,87,2887,2
201608,금천구,659,767,645,268,646,88,3073,2
201608,노원구,1667,1833,1725,527,1709,312,7773,7
201608,도봉구,591,672,678,264,668,108,2981,2
201608,동대문구,946,1063,909,211,759,94,3982,3
201608,동작구,544,646,592,256,577,105,2720,2
201608,마포구,570,659,551,262,583,85,2710,2
201608,서대문구,492,547,549,527,529,70,2714,2
201608,서초구,290,337,255,182,302,53,1419,1
201608,성동구,503,557,550,150,460,67,2287,1
201608,성북구,864,975,914,372,826,128,4079,3
201608,송파구,601,600,488,220,516,93,2518,2
201608,양천구,648,712,690,270,660,93,3073,2
201608,영등포구,807,715,605,204,595,98,3024,2
201608,용산구,508,530,500,153,407,69,2167,1
201608,은평구,1256,1295,1115,441,1115,156,5378,5
201608,종로구,358,423,320,40,299,83,1523,1
201608,중구,381,379,343,83,340,40,1566,1
201608,중랑구,1041,1052,939,358,1016,191,4597,4
201609,강남구,891,905,696,400,667,129,3688,3
201609,강동구,655,645,615,286,589,110,2900,2
201609,강북구,1020,1189,1029,362,956,140,4696,4
201609,강서구,1376,1484,1504,398,1557,267,6586,6
201609,관악구,902,958,918,324,840,132,4074,3
201609,광진구,442,493,419,159,448,66,2027,1
201609,구로구,572,666,687,293,604,91,2913,2
201609,금천구,661,764,653,264,646,89,3077,2
201609,노원구,1671,1831,1737,523,1711,317,7790,7
201609,도봉구,591,675,685,262,661,111,2985,2
201609,동대문구,948,1066,902,203,771,92,3982,3
201609,동작구,549,659,594,257,585,103,2747,2
201609,마포구,563,658,544,261,587,84,2697,2
201609,서대문구,485,553,554,519,536,71,2718,2
201609,서초구,291,341,260,184,304,52,1432,1
201609,성동구,495,562,538,150,470,68,2283,1
201609,성북구,872,972,924,371,821,125,4085,3
201609,송파구,601,602,504,219,522,92,2540,2
201609,양천구,660,714,692,260,663,92,3081,2
201609,영등포구,808,710,616,203,595,93,3025,2
201609,용산구,518,526,505,154,408,71,2182,1
201609,은평구,1253,1299,1128,426,1113,159,5378,5
201609,종로구,361,425,317,39,300,81,1523,1
201609,중구,381,378,337,81,344,38,1559,1
201609,중랑구,1042,1054,946,353,1029,196,4620,4
201610,강남구,893,909,708,413,669,130,3722,3
201610,강동구,646,652,610,274,604,111,2897,2
201610,강북구,1020,1196,1036,356,966,142,4716,4
201610,강서구,1378,1480,1525,399,1552,275,6609,6
201610,관악구,914,959,918,321,855,138,4105,3
201610,광진구,451,487,417,153,449,68,2025,1
201610,구로구,561,680,675,278,612,88,2894,2
201610,금천구,662,778,658,259,650,92,3099,2
201610,노원구,1663,1832,1740,524,1719,312,7790,7
201610,도봉구,587,680,685,263,667,114,2996,2
201610,동대문구,948,1075,908,204,769,93,3997,3
201610,동작구,549,656,599,248,591,103,2746,2
201610,마포구,550,660,546,258,594,87,2695,2
201610,서대문구,476,560,561,522,537,72,2728,2
201610,서초구,286,338,266,186,300,53,1429,1
201610,성동구,489,555,550,143,468,69,2274,1
201610,성북구,862,965,934,365,826,126,4078,3
201610,송파구,606,605,507,204,522,93,2537,2
201610,양천구,655,716,695,252,663,89,3070,2
201610,영등포구,788,704,615,203,585,96,2991,2
201610,용산구,519,523,501,150,412,71,2176,1
201610,은평구,1261,1302,1127,420,1112,162,5384,5
201610,종로구,365,425,321,38,299,79,1527,1
201610,중구,390,375,343,95,344,40,1587,1
201610,중랑구,1038,1031,957,341,1035,198,4600,4
201611,강남구,902,913,709,380,674,129,3707,3
201611,강동구,638,643,604,269,600,107,2861,2
201611,강북구,1008,1200,1038,335,976,139,4696,4
201611,강서구,1390,1491,1534,389,1569,272,6645,6
201611,관악구,910,958,912,326,856,141,4103,3
201611,광진구,450,481,422,144,459,66,2022,1
201611,구로구,566,682,668,282,615,88,2901,2
201611,금천구,668,764,656,248,648,87,3071,2
201611,노원구,1654,1844,1742,526,1722,316,7804,7
201611,도봉구,578,666,688,258,673,110,2973,2
201611,동대문구,961,1067,914,206,772,94,4014,3
201611,동작구,555,661,603,246,591,101,2757,2
201611,마포구,544,649,541,256,591,86,2667,2
201611,서대문구,481,565,569,524,533,73,2745,2
201611,서초구,289,341,276,190,301,54,1451,1
201611,성동구,492,553,533,137,472,71,2258,1
201611,성북구,848,948,931,352,818,124,4021,3
201611,송파구,619,613,496,205,526,94,2553,2
201611,양천구,658,706,694,233,652,92,3035,2
201611,영등포구,787,693,606,202,584,96,2968,2
201611,용산구,512,519,495,148,412,70,2156,1
201611,은평구,1247,1280,1128,413,1112,159,5339,5
201611,종로구,370,419,327,43,298,81,1538,1
201611,중구,394,372,345,96,347,40,1594,1
201611,중랑구,1026,1034,957,325,1036,199,4577,4
201612,강남구,901,897,714,360,676,131,3679,3
201612,강동구,652,636,608,280,600,112,2888,2
201612,강북구,1001,1180,1034,334,971,137,4657,4
201612,강서구,1393,1509,1523,387,1589,272,6673,6
201612,관악구,914,943,918,312,857,146,4090,3
201612,광진구,451,480,409,136,449,67,1992,1
201612,구로구,562,667,663,277,612,86,2867,2
201612,금천구,666,756,658,241,653,85,3059,2
201612,노원구,1637,1825,1748,509,1732,317,7768,7
201612,도봉구,570,658,693,242,668,108,2939,2
201612,동대문구,956,1054,927,200,769,95,4001,3
201612,동작구,543,656,608,242,589,102,2740,2
201612,마포구,530,646,538,262,598,86,2660,2
201612,서대문구,479,550,564,533,537,74,2737,2
201612,서초구,284,338,269,190,304,50,1435,1
201612,성동구,499,543,532,136,461,70,2241,1
201612,성북구,845,937,926,343,820,125,3996,3
201612,송파구,622,608,495,192,531,99,2547,2
201612,양천구,646,695,690,224,659,96,3010,2
201612,영등포구,772,686,599,195,586,93,2931,2
201612,용산구,508,513,485,143,412,72,2133,1
201612,은평구,1230,1275,1148,402,1105,162,5322,5
201612,종로구,367,416,325,39,303,79,1529,1
201612,중구,388,367,345,94,343,40,1577,1
201612,중랑구,1016,1040,946,309,1042,192,4545,4
201701,강남구,899,885,718,363,682,134,3681,3
201701,강동구,648,624,617,273,607,115,2884,2
201701,강북구,993,1178,1056,331,984,138,4680,4
201701,강서구,1394,1500,1544,386,1607,277,6708,6
201701,관악구,921,935,917,309,869,150,4101,3
201701,광진구,453,474,408,134,457,68,1994,1
201701,구로구,562,670,677,269,614,94,2886,2
201701,금천구,667,751,663,232,659,88,3060,2
201701,노원구,1638,1821,1763,507,1746,313,7788,7
201701,도봉구,571,664,696,236,673,111,2951,2
201701,동대문구,957,1054,935,195,774,98,4013,3
201701,동작구,536,654,619,243,593,100,2745,2
201701,마포구,532,639,542,254,595,92,2654,2
201701,서대문구,468,544,573,529,548,76,2738,2
201701,서초구,289,339,275,186,305,50,1444,1
201701,성동구,494,550,529,131,471,70,2245,1
201701,성북구,832,936,924,338,819,128,3977,3
201701,송파구,610,612,503,193,535,101,2554,2
201701,양천구,641,688,694,221,672,96,3012,2
201701,영등포구,766,687,610,198,585,96,2942,2
201701,용산구,511,505,481,138,417,72,2124,1
201701,은평구,1219,1276,1163,405,1121,165,5349,5
201701,종로구,368,422,327,33,302,79,1531,1
201701,중구,384,367,350,95,351,41,1588,1
201701,중랑구,1001,1045,947,312,1051,198,4554,4
201702,강남구,894,901,722,368,690,136,3711,3
201702,강동구,646,629,620,263,617,113,2888,2
201702,강북구,999,1169,1069,322,993,136,4688,4
201702,강서구,1400,1508,1547,389,1610,281,6735,6
201702,관악구,909,950,924,296,872,152,4103,3
201702,광진구,458,469,420,139,456,69,2011,1
201702,구로구,562,673,677,275,619,94,2900,2
201702,금천구,667,752,679,228,663,90,3079,2
201702,노원구,1648,1816,1780,507,1756,310,7817,7
201702,도봉구,575,658,709,239,684,114,2979,2
201702,동대문구,951,1067,935,194,782,103,4032,3
201702,동작구,531,660,622,233,594,98,2738,2
201702,마포구,538,637,546,241,601,93,2656,2
201702,서대문구,473,541,582,549,547,78,2770,2
201702,서초구,293,338,278,183,309,49,1450,1
201702,성동구,493,547,527,129,475,71,2242,1
201702,성북구,833,927,934,336,820,128,3978,3
201702,송파구,606,616,503,200,535,108,2568,2
201702,양천구,637,695,705,226,678,94,3035,2
201702,영등포구,773,680,614,201,596,94,2958,2
201702,용산구,511,507,488,146,414,74,2140,1
201702,은평구,1217,1295,1161,403,1136,168,5380,5
201702,종로구,362,433,325,34,311,77,1542,1
201702,중구,379,369,350,96,354,44,1592,1
201702,중랑구,994,1046,964,316,1042,208,4570,4
201703,강남구,892,907,725,353,690,140,3707,3
201703,강동구,651,636,625,260,623,112,2907,2
201703,강북구,1011,1168,1085,327,996,142,4729,4
201703,강서구,1416,1524,1547,391,1628,281,6787,6
201703,관악구,927,957,927,298,881,152,4142,3
201703,광진구,466,464,428,138,451,70,2017,1
201703,구로구,554,675,687,274,632,94,2916,2
201703,금천구,676,752,690,234,666,95,3113,2
201703,노원구,1653,1809,1812,516,1769,314,7873,7
201703,도봉구,589,659,708,244,693,112,3005,2
201703,동대문구,948,1065,938,194,792,105,4042,3
201703,동작구,528,657,622,237,606,104,2754,2
201703,마포구,540,627,563,236,604,91,2661,2
201703,서대문구,469,536,590,545,558,76,2774,2
201703,서초구,310,333,280,182,312,50,1467,1
201703,성동구,498,547,533,129,484,66,2257,1
201703,성북구,836,928,943,350,824,135,4016,3
201703,송파구,608,614,505,204,535,109,2575,2
201703,양천구,633,692,698,234,692,94,3043,2
201703,영등포구,761,675,620,196,590,101,2943,2
201703,용산구,500,503,491,148,420,74,2136,1
201703,은평구,1221,1294,1167,412,1150,172,5416,5
201703,종로구,370,428,337,36,308,79,1558,1
201703,중구,381,373,342,94,359,44,1593,1
201703,중랑구,999,1057,973,312,1043,208,4592,4
201704,강남구,901,909,729,374,694,142,3749,3
201704,강동구,645,633,622,263,633,115,2911,2
201704,강북구,1003,1166,1092,346,1000,150,4757,4
201704,강서구,1431,1524,1570,399,1640,278,6842,6
201704,관악구,927,966,940,315,885,153,4186,3
201704,광진구,474,458,424,154,453,76,2039,1
201704,구로구,544,681,685,277,637,94,2918,2
201704,금천구,673,756,700,253,664,97,3143,2
201704,노원구,1656,1790,1836,518,1772,313,7885,7
201704,도봉구,588,663,713,254,700,117,3035,2
201704,동대문구,951,1057,946,198,796,106,4054,3
201704,동작구,539,646,627,244,610,101,2767,2
201704,마포구,546,623,565,226,613,95,2668,2
201704,서대문구,470,544,601,598,556,77,2846,2
201704,서초구,310,335,280,192,310,53,1480,1
201704,성동구,497,534,540,135,489,65,2260,1
201704,성북구,841,941,935,350,830,140,4037,3
201704,송파구,614,614,508,236,533,109,2614,2
201704,양천구,649,692,690,246,702,95,3074,2
201704,영등포구,751,677,624,213,593,101,2959,2
201704,용산구,502,501,493,153,431,73,2153,1
201704,은평구,1226,1283,1186,444,1156,175,5470,5
201704,종로구,376,424,343,40,313,81,1577,1
201704,중구,380,367,345,102,363,44,1601,1
201704,중랑구,1012,1073,962,361,1044,208,4660,4
201705,강남구,913,914,749,377,695,144,3792,3
201705,강동구,649,634,625,267,633,118,2926,2
201705,강북구,1028,1154,1101,355,1020,154,4812,4
201705,강서구,1453,1532,1573,407,1645,284,6894,6
201705,관악구,940,981,953,326,883,152,4235,4
201705,광진구,475,458,429,165,451,76,2054,1
201705,구로구,557,677,684,290,641,95,2944,2
201705,금천구,676,748,710,256,665,98,3153,2
201705,노원구,1692,1762,1852,536,1772,309,7923,7
201705,도봉구,589,667,713,275,708,117,3069,2
201705,동대문구,957,1028,954,191,791,111,4032,3
201705,동작구,545,636,632,257,602,102,2774,2
201705,마포구,558,629,566,229,614,91,2687,2
201705,서대문구,479,537,600,608,565,76,2865,2
201705,서초구,306,333,280,203,309,58,1489,1
201705,성동구,497,536,533,138,486,67,2257,1
201705,성북구,837,935,948,365,823,145,4053,3
201705,송파구,613,616,514,234,535,113,2625,2
201705,양천구,662,678,695,258,695,98,3086,2
201705,영등포구,746,672,624,215,586,100,2943,2
201705,용산구,513,495,486,160,433,75,2162,1
201705,은평구,1240,1273,1182,443,1153,168,5459,5
201705,종로구,386,423,349,47,317,81,1603,1
201705,중구,381,361,346,100,363,44,1595,1
201705,중랑구,1011,1071,971,373,1050,207,4683,4
201706,강남구,906,905,769,365,699,141,3785,3
201706,강동구,666,628,637,256,629,121,2937,2
201706,강북구,1013,1151,1109,335,1042,157,4807,4
201706,강서구,1467,1530,1588,396,1639,291,6911,6
201706,관악구,920,990,970,318,906,153,4257,4
201706,광진구,482,457,433,147,448,77,2044,1
201706,구로구,564,678,693,284,640,96,2955,2
201706,금천구,687,728,722,243,673,101,3154,2
201706,노원구,1710,1765,1860,508,1773,318,7934,7
201706,도봉구,591,670,726,267,722,121,3097,2
201706,동대문구,960,1024,965,186,797,111,4043,3
201706,동작구,549,647,639,260,603,108,2806,2
201706,마포구,567,621,570,223,617,92,2690,2
201706,서대문구,488,540,611,604,571,77,2891,2
201706,서초구,316,333,280,193,306,60,1488,1
201706,성동구,494,535,526,137,484,68,2244,1
201706,성북구,831,947,946,356,829,148,4057,3
201706,송파구,616,625,511,218,545,117,2632,2
201706,양천구,664,671,702,246,702,98,3083,2
201706,영등포구,746,671,625,212,578,100,2932,2
201706,용산구,519,501,483,157,439,75,2174,1
201706,은평구,1251,1254,1191,429,1154,171,5450,5
201706,종로구,396,416,361,42,317,80,1612,1
201706,중구,379,358,346,100,364,44,1591,1
201706,중랑구,1016,1073,968,352,1077,209,4695,4
201707,강남구,917,889,782,389,706,140,3823,3
201707,강동구,679,624,636,261,632,123,2955,2
201707,강북구,1012,1147,1098,333,1054,153,4797,4
201707,강서구,1470,1542,1586,396,1651,288,6933,6
201707,관악구,919,1010,977,321,913,155,4295,4
201707,광진구,480,464,437,138,445,79,2043,1
201707,구로구,573,679,686,288,643,95,2964,2
201707,금천구,688,725,723,238,669,101,3144,2
201707,노원구,1721,1755,1883,507,1763,310,7939,7
201707,도봉구,601,678,725,267,724,126,3121,2
201707,동대문구,969,1021,977,184,799,112,4062,3
201707,동작구,567,646,642,254,604,109,2822,2
201707,마포구,564,625,578,237,613,95,2712,2
201707,서대문구,488,538,617,608,573,76,2900,2
201707,서초구,321,330,274,191,312,56,1484,1
201707,성동구,490,542,525,137,488,68,2250,1
201707,성북구,834,946,953,362,831,151,4077,3
201707,송파구,620,613,521,211,546,116,2627,2
201707,양천구,668,679,697,239,705,98,3086,2
201707,영등포구,758,669,626,207,579,97,2936,2
201707,용산구,522,502,487,162,442,77,2192,1
201707,은평구,1258,1250,1197,419,1151,174,5449,5
201707,종로구,402,411,365,41,313,81,1613,1
201707,중구,381,355,346,98,363,46,1589,1
201707,중랑구,1028,1089,985,346,1084,212,4744,4
201708,강남구,928,891,787,379,705,143,3833,3
201708,강동구,688,622,640,249,635,120,2954,2
201708,강북구,1030,1143,1089,321,1051,156,4790,4
201708,강서구,1489,1534,1600,391,1649,289,6952,6
201708,관악구,919,1008,983,317,920,159,4306,4
201708,광진구,474,465,437,140,445,75,2036,1
201708,구로구,583,683,685,281,642,93,2967,2
201708,금천구,684,737,723,242,675,101,3162,2
201708,노원구,1734,1740,1900,503,1769,305,7951,7
201708,도봉구,603,678,730,260,731,129,3131,2
201708,동대문구,970,1015,991,183,799,114,4072,3
201708,동작구,574,642,643,258,607,107,2831,2
201708,마포구,568,626,581,230,602,97,2704,2
201708,서대문구,495,544,621,597,572,75,2904,2
201708,서초구,326,330,282,183,309,56,1486,1
201708,성동구,499,546,530,132,491,69,2267,1
201708,성북구,836,943,961,348,845,148,4081,3
201708,송파구,637,607,533,208,556,115,2656,2
201708,양천구,670,685,697,235,708,99,3094,2
201708,영등포구,769,658,627,213,585,97,2949,2
201708,용산구,526,506,490,162,440,82,2206,1
201708,은평구,1273,1247,1207,417,1142,168,5454,5
201708,종로구,408,409,362,38,315,80,1612,1
201708,중구,388,356,347,98,357,47,1593,1
201708,중랑구,1048,1092,992,340,1085,211,4768,4
201709,강남구,931,901,778,372,708,146,3836,3
201709,강동구,696,623,653,245,633,120,2970,2
201709,강북구,1042,1139,1098,303,1048,160,4790,4
201709,강서구,1491,1541,1609,387,1655,289,6972,6
201709,관악구,924,1012,982,319,930,166,4333,4
201709,광진구,485,467,446,132,444,74,2048,1
201709,구로구,583,687,689,274,641,97,2971,2
201709,금천구,683,737,740,234,679,103,3176,2
201709,노원구,1737,1740,1916,495,1781,308,7977,8
201709,도봉구,611,676,734,253,738,126,3138,2
201709,동대문구,978,1004,990,178,803,114,4067,3
201709,동작구,582,646,659,253,609,108,2857,2
201709,마포구,583,623,588,233,603,99,2729,2
201709,서대문구,503,550,624,590,575,79,2921,2
201709,서초구,327,331,289,182,310,54,1493,1
201709,성동구,511,545,526,128,495,69,2274,1
201709,성북구,834,961,967,346,848,149,4105,3
201709,송파구,635,611,537,209,552,118,2662,2
201709,양천구,683,692,696,225,712,102,3110,2
201709,영등포구,765,666,635,210,581,98,2955,2
201709,용산구,520,509,491,158,445,84,2207,1
201709,은평구,1286,1241,1224,406,1157,168,5482,5
201709,종로구,421,411,367,37,315,82,1633,1
201709,중구,395,363,346,98,362,46,1610,1
201709,중랑구,1060,1092,999,329,1097,212,4789,4
201710,강남구,930,897,790,351,706,150,3824,3
201710,강동구,698,622,668,238,626,125,2977,2
201710,강북구,1027,1135,1113,298,1044,165,4782,4
201710,강서구,1513,1534,1615,387,1658,287,6994,6
201710,관악구,917,1022,992,315,940,166,4352,4
201710,광진구,488,469,450,127,448,76,2058,1
201710,구로구,580,684,690,270,645,99,2968,2
201710,금천구,691,730,753,230,682,101,3187,2
201710,노원구,1739,1744,1933,491,1786,313,8006,8
201710,도봉구,608,674,741,248,744,127,3142,2
201710,동대문구,973,996,1006,169,811,117,4072,3
201710,동작구,588,650,667,255,612,105,2877,2
201710,마포구,587,618,596,223,603,99,2726,2
201710,서대문구,509,541,632,583,576,79,2920,2
201710,서초구,326,334,292,179,310,55,1496,1
201710,성동구,514,536,535,119,497,67,2268,1
201710,성북구,830,949,978,343,854,152,4106,3
201710,송파구,637,619,538,206,556,121,2677,2
201710,양천구,704,680,705,224,722,104,3139,2
201710,영등포구,770,658,654,208,579,94,2963,2
201710,용산구,518,506,501,156,454,84,2219,1
201710,은평구,1279,1248,1219,402,1166,168,5482,5
201710,종로구,430,398,377,35,317,81,1638,1
201710,중구,402,358,358,100,354,47,1619,1
201710,중랑구,1079,1084,1019,325,1089,209,4805,4
201711,강남구,931,891,796,346,703,146,3813,3
201711,강동구,696,616,669,230,634,127,2972,2
201711,강북구,1023,1136,1132,291,1052,162,4796,4
201711,강서구,1534,1532,1629,373,1652,294,7014,6
201711,관악구,918,1034,996,318,941,166,4373,4
201711,광진구,491,481,453,124,444,76,2069,1
201711,구로구,582,681,705,279,650,99,2996,2
201711,금천구,693,717,766,226,682,102,3186,2
201711,노원구,1742,1744,1945,486,1795,312,8024,8
201711,도봉구,609,689,751,248,743,129,3169,2
201711,동대문구,988,1002,996,167,823,116,4092,3
201711,동작구,585,644,678,245,614,107,2873,2
201711,마포구,578,617,596,216,604,101,2712,2
201711,서대문구,513,541,629,592,582,82,2939,2
201711,서초구,327,332,292,169,314,59,1493,1
201711,성동구,526,534,543,118,498,68,2287,1
201711,성북구,836,939,977,333,858,154,4097,3
201711,송파구,641,620,541,193,564,125,2684,2
201711,양천구,705,688,712,212,725,104,3146,2
201711,영등포구,762,653,661,203,578,96,2953,2
201711,용산구,519,512,493,152,461,78,2215,1
201711,은평구,1284,1261,1221,401,1182,167,5516,5
201711,종로구,425,398,380,31,318,83,1635,1
201711,중구,407,349,363,103,355,50,1627,1
201711,중랑구,1085,1065,1028,316,1098,208,4800,4
201712,강남구,926,888,781,330,701,143,3769,3
201712,강동구,679,606,668,228,627,130,2938,2
201712,강북구,1022,1129,1135,285,1054,161,4786,4
201712,강서구,1535,1521,1632,375,1630,296,6989,6
201712,관악구,903,1024,995,313,940,162,4337,4
201712,광진구,489,474,447,125,452,73,2060,1
201712,구로구,594,673,701,267,658,95,2988,2
201712,금천구,686,720,751,223,683,105,3168,2
201712,노원구,1748,1737,1934,485,1796,314,8014,8
201712,도봉구,615,678,750,241,735,128,3147,2
201712,동대문구,983,992,990,162,819,112,4058,3
201712,동작구,578,631,684,242,621,105,2861,2
201712,마포구,562,603,597,213,599,100,2674,2
201712,서대문구,502,537,636,598,575,82,2930,2
201712,서초구,330,335,297,158,311,60,1491,1
201712,성동구,528,531,539,115,506,71,2290,1
201712,성북구,836,937,972,313,862,156,4076,3
201712,송파구,646,607,541,189,568,120,2671,2
201712,양천구,697,687,714,213,716,104,3131,2
201712,영등포구,759,642,654,194,577,92,2918,2
201712,용산구,524,511,492,151,461,78,2217,1
201712,은평구,1262,1259,1210,400,1192,173,5496,5
201712,종로구,418,396,382,29,315,84,1624,1
201712,중구,405,353,364,104,342,54,1622,1
201712,중랑구,1087,1051,1015,308,1086,212,4759,4
201801,강남구,931,892,779,333,709,144,3788,3
201801,강동구,689,613,675,226,634,131,2968,2
201801,강북구,1029,1135,1149,290,1041,164,4808,4
201801,강서구,1546,1533,1639,373,1645,292,7028,6
201801,관악구,916,1016,1010,311,949,168,4370,4
201801,광진구,491,477,460,126,457,71,2082,1
201801,구로구,581,670,701,261,659,98,2970,2
201801,금천구,684,732,753,214,691,109,3183,2
201801,노원구,1778,1744,1921,479,1826,313,8061,8
201801,도봉구,612,688,747,230,748,136,3161,2
201801,동대문구,990,978,1001,164,822,111,4066,3
201801,동작구,579,635,690,237,622,105,2868,2
201801,마포구,568,605,604,210,600,101,2688,2
201801,서대문구,509,534,643,585,581,81,2933,2
201801,서초구,333,332,300,158,313,60,1496,1
201801,성동구,540,532,541,119,514,69,2315,1
201801,성북구,848,936,978,299,873,157,4091,3
201801,송파구,659,610,547,181,574,119,2690,2
201801,양천구,704,690,716,210,734,106,3160,2
201801,영등포구,747,650,652,197,581,94,2921,2
201801,용산구,518,512,496,147,455,77,2205,1
201801,은평구,1252,1274,1213,401,1198,184,5522,5
201801,종로구,418,397,386,33,320,85,1639,1
201801,중구,393,361,365,104,336,56,1615,1
201801,중랑구,1102,1072,1020,303,1105,213,4815,4
201802,강남구,929,903,779,320,720,145,3796,3
201802,강동구,703,602,677,229,637,134,2982,2
201802,강북구,1031,1118,1167,291,1052,165,4824,4
201802,강서구,1559,1544,1641,362,1646,299,7051,7
201802,관악구,923,1026,1016,315,957,168,4405,4
201802,광진구,494,490,464,124,461,73,2106,1
201802,구로구,577,669,704,252,665,100,2967,2
201802,금천구,684,721,765,207,691,109,3177,2
201802,노원구,1777,1735,1931,478,1846,314,8081,8
201802,도봉구,619,692,750,235,760,140,3196,2
201802,동대문구,995,970,1002,168,832,113,4080,3
201802,동작구,574,634,693,238,622,105,2866,2
201802,마포구,568,603,614,216,611,95,2707,2
201802,서대문구,508,536,648,602,579,82,2955,2
201802,서초구,334,334,310,159,307,66,1510,1
201802,성동구,520,537,542,119,526,71,2315,1
201802,성북구,850,935,989,298,880,159,4111,3
201802,송파구,670,603,554,179,581,120,2707,2
201802,양천구,703,692,723,209,739,103,3169,2
201802,영등포구,751,648,655,190,588,96,2928,2
201802,용산구,516,507,501,153,456,80,2213,1
201802,은평구,1251,1286,1225,403,1202,184,5551,5
201802,종로구,416,394,387,32,325,83,1637,1
201802,중구,394,367,361,104,339,57,1622,1
201802,중랑구,1106,1083,1030,296,1117,218,4850,4
201803,강남구,941,912,774,313,728,146,3814,3
201803,강동구,704,606,664,232,654,136,2996,2
201803,강북구,1028,1125,1172,290,1073,173,4861,4
201803,강서구,1565,1541,1659,370,1656,300,7091,7
201803,관악구,929,1022,1017,324,978,163,4433,4
201803,광진구,500,488,468,131,462,77,2126,1
201803,구로구,574,671,711,241,669,102,2968,2
201803,금천구,682,714,770,209,693,110,3178,2
201803,노원구,1788,1727,1929,487,1871,313,8115,8
201803,도봉구,636,688,754,239,768,146,3231,2
201803,동대문구,998,977,998,168,842,115,4098,3
201803,동작구,576,636,690,237,630,109,2878,2
201803,마포구,558,612,606,218,619,94,2707,2
201803,서대문구,519,536,642,596,589,85,2967,2
201803,서초구,341,336,316,155,311,67,1526,1
201803,성동구,520,533,544,128,525,74,2324,1
201803,성북구,864,929,996,304,886,165,4144,3
201803,송파구,691,593,562,178,589,120,2733,2
201803,양천구,716,690,723,218,741,102,3190,2
201803,영등포구,759,653,655,191,590,99,2947,2
201803,용산구,535,501,509,159,459,80,2243,1
201803,은평구,1265,1288,1221,429,1213,189,5605,5
201803,종로구,411,392,395,33,323,83,1637,1
201803,중구,397,368,357,103,342,59,1626,1
201803,중랑구,1105,1071,1043,298,1133,216,4866,4
201804,강남구,944,906,784,321,739,148,3842,3
201804,강동구,703,618,659,237,671,132,3020,2
201804,강북구,1038,1119,1173,301,1090,173,4894,4
201804,강서구,1560,1558,1662,379,1662,303,7124,7
201804,관악구,933,1031,1030,336,980,162,4472,4
201804,광진구,508,502,464,144,465,78,2161,1
201804,구로구,577,668,712,245,684,100,2986,2
201804,금천구,687,716,778,208,702,110,3201,2
201804,노원구,1774,1730,1919,487,1879,314,8103,8
201804,도봉구,639,691,753,248,773,152,3256,2
201804,동대문구,1009,959,1002,178,846,116,4110,3
201804,동작구,572,644,686,239,632,112,2885,2
201804,마포구,564,610,613,226,621,98,2732,2
201804,서대문구,520,538,640,610,595,87,2990,2
201804,서초구,347,343,311,169,312,69,1551,1
201804,성동구,513,537,537,126,527,76,2316,1
201804,성북구,872,931,994,304,900,164,4165,3
201804,송파구,706,596,564,180,596,119,2761,2
201804,양천구,720,694,730,231,742,100,3217,2
201804,영등포구,750,661,662,192,582,98,2945,2
201804,용산구,545,505,507,166,466,80,2269,1
201804,은평구,1248,1286,1228,441,1208,193,5604,5
201804,종로구,403,390,402,34,322,83,1634,1
201804,중구,396,370,358,109,345,58,1636,1
201804,중랑구,1112,1072,1040,330,1131,220,4905,4
201805,강남구,933,922,783,331,734,145,3848,3
201805,강동구,700,621,659,244,674,134,3032,2
201805,강북구,1045,1120,1187,316,1095,173,4936,4
201805,강서구,1573,1564,1666,383,1683,300,7169,7
201805,관악구,929,1032,1028,335,972,165,4461,4
201805,광진구,520,506,461,159,465,78,2189,1
201805,구로구,586,670,699,252,693,102,3002,2
201805,금천구,688,720,781,219,714,109,3231,2
201805,노원구,1775,1741,1923,506,1892,319,8156,8
201805,도봉구,644,697,745,262,781,155,3284,3
201805,동대문구,1017,958,991,185,857,115,4123,3
201805,동작구,571,651,685,260,629,112,2908,2
201805,마포구,578,609,614,230,625,97,2753,2
201805,서대문구,523,546,640,635,602,87,3033,2
201805,서초구,354,338,315,167,307,71,1552,1
201805,성동구,515,542,540,130,524,76,2327,2
201805,성북구,881,913,995,316,902,160,4167,3
201805,송파구,703,611,560,193,595,120,2782,2
201805,양천구,723,705,725,235,752,103,3243,2
201805,영등포구,751,668,661,195,580,100,2955,2
201805,용산구,550,505,504,162,456,82,2259,1
201805,은평구,1259,1279,1234,448,1216,194,5630,5
201805,종로구,404,395,401,39,321,82,1642,1
201805,중구,401,377,355,112,343,58,1646,1
201805,중랑구,1120,1085,1044,349,1135,221,4954,4
201806,강남구,933,925,779,315,727,144,3823,3
201806,강동구,707,625,668,242,669,136,3047,2
201806,강북구,1053,1130,1192,320,1096,173,4964,4
201806,강서구,1582,1577,1653,384,1695,302,7193,7
201806,관악구,941,1027,1037,343,975,161,4484,4
201806,광진구,529,509,456,156,466,79,2195,1
201806,구로구,585,671,688,253,696,106,2999,2
201806,금천구,683,727,769,223,707,113,3222,2
201806,노원구,1786,1751,1927,503,1898,314,8179,8
201806,도봉구,639,705,735,252,776,155,3262,2
201806,동대문구,1027,965,997,180,853,117,4139,3
201806,동작구,577,661,681,257,637,115,2928,2
201806,마포구,581,604,611,235,624,95,2750,2
201806,서대문구,515,545,642,633,604,90,3029,2
201806,서초구,356,352,311,172,312,70,1573,1
201806,성동구,523,543,538,130,522,74,2330,2
201806,성북구,891,914,994,309,906,163,4177,3
201806,송파구,705,611,577,195,590,124,2802,2
201806,양천구,743,709,733,230,751,103,3269,3
201806,영등포구,757,670,674,192,580,103,2976,2
201806,용산구,557,509,504,155,460,83,2268,1
201806,은평구,1269,1284,1239,440,1221,203,5656,5
201806,종로구,413,395,407,34,317,83,1649,1
201806,중구,395,387,356,113,342,61,1654,1
201806,중랑구,1133,1096,1061,346,1129,229,4994,4
201807,강남구,935,930,779,296,725,148,3813,3
201807,강동구,721,630,664,240,667,139,3061,2
201807,강북구,1059,1143,1188,317,1101,175,4983,4
201807,강서구,1605,1605,1648,375,1699,306,7238,7
201807,관악구,955,1030,1033,327,981,161,4487,4
201807,광진구,530,517,460,153,469,81,2210,1
201807,구로구,576,673,673,249,702,107,2980,2
201807,금천구,680,728,766,222,711,114,3221,2
201807,노원구,1783,1752,1938,509,1906,311,8199,8
201807,도봉구,639,712,733,244,790,153,3271,3
201807,동대문구,1032,955,1007,174,848,117,4133,3
201807,동작구,583,665,684,253,634,115,2934,2
201807,마포구,579,610,609,237,629,92,2756,2
201807,서대문구,519,551,643,633,607,97,3050,2
201807,서초구,357,356,302,167,321,71,1574,1
201807,성동구,524,554,535,128,523,77,2341,2
201807,성북구,892,916,983,295,920,171,4177,3
201807,송파구,711,621,583,198,593,119,2825,2
201807,양천구,748,721,729,228,758,104,3288,3
201807,영등포구,753,675,674,196,595,105,2998,2
201807,용산구,561,514,507,157,463,84,2286,1
201807,은평구,1265,1286,1241,429,1236,197,5654,5
201807,종로구,414,398,404,33,324,82,1655,1
201807,중구,398,379,357,110,342,61,1647,1
201807,중랑구,1133,1120,1054,344,1138,233,5022,4
201808,강남구,930,929,788,282,726,147,3802,3
201808,강동구,720,639,668,235,672,139,3073,2
201808,강북구,1058,1139,1187,319,1102,177,4982,4
201808,강서구,1612,1600,1654,368,1702,309,7245,7
201808,관악구,966,1037,1026,319,1003,164,4515,4
201808,광진구,531,526,468,150,474,80,2229,1
201808,구로구,590,667,682,258,703,108,3008,2
201808,금천구,682,723,768,215,713,114,3215,2
201808,노원구,1778,1753,1944,518,1923,313,8229,8
201808,도봉구,642,713,734,231,797,153,3270,3
201808,동대문구,1036,971,1007,164,853,113,4144,3
201808,동작구,596,665,689,254,639,116,2959,2
201808,마포구,583,606,612,239,629,94,2763,2
201808,서대문구,518,561,637,629,616,97,3058,2
201808,서초구,355,357,301,163,318,71,1565,1
201808,성동구,533,556,537,125,532,81,2364,2
201808,성북구,905,925,982,289,922,175,4198,3
201808,송파구,714,633,583,189,595,121,2835,2
201808,양천구,763,722,737,224,752,108,3306,3
201808,영등포구,762,680,683,190,610,104,3029,2
201808,용산구,560,521,501,153,470,82,2287,1
201808,은평구,1274,1304,1238,427,1251,197,5691,5
201808,종로구,406,405,395,33,325,83,1647,1
201808,중구,406,381,360,105,340,62,1654,1
201808,중랑구,1135,1129,1055,330,1148,236,5033,4
201809,강남구,926,929,793,285,722,148,3803,3
201809,강동구,723,642,670,231,679,144,3089,2
201809,강북구,1072,1134,1203,314,1109,181,5013,4
201809,강서구,1623,1602,1660,368,1696,314,7263,7
201809,관악구,976,1033,1031,321,1005,170,4536,4
201809,광진구,548,523,464,153,487,82,2257,1
201809,구로구,605,676,680,259,716,109,3045,2
201809,금천구,698,718,774,213,720,115,3238,2
201809,노원구,1779,1754,1955,524,1935,322,8269,8
201809,도봉구,644,724,729,227,803,155,3282,3
201809,동대문구,1034,982,1001,159,862,114,4152,3
201809,동작구,597,663,697,250,640,115,2962,2
201809,마포구,589,609,618,243,633,94,2786,2
201809,서대문구,515,558,641,631,627,99,3071,2
201809,서초구,351,361,303,156,320,72,1563,1
201809,성동구,538,553,536,117,529,80,2353,2
201809,성북구,906,915,991,278,930,173,4193,3
201809,송파구,727,632,595,194,600,125,2873,2
201809,양천구,765,719,738,220,757,111,3310,3
201809,영등포구,760,686,682,194,614,109,3045,2
201809,용산구,571,517,504,152,477,81,2302,1
201809,은평구,1273,1310,1243,412,1254,200,5692,5
201809,종로구,414,399,404,35,328,84,1664,1
201809,중구,410,385,363,105,341,66,1670,1
201809,중랑구,1147,1131,1058,319,1162,237,5054,4
201810,강남구,966,963,829,270,743,159,3930,3
201810,강동구,736,667,700,230,717,150,3200,2
201810,강북구,1169,1231,1300,313,1198,188,5399,5
201810,강서구,1689,1661,1741,369,1811,330,7601,7
201810,관악구,1013,1082,1120,330,1149,194,4888,4
201810,광진구,614,570,524,170,594,93,2565,2
201810,구로구,623,688,697,270,746,111,3135,2
201810,금천구,721,733,803,211,755,121,3344,3
201810,노원구,1874,1869,2089,535,2040,337,8744,8
201810,도봉구,674,752,795,225,893,175,3514,3
201810,동대문구,1075,1019,1083,167,954,129,4427,4
201810,동작구,627,691,729,257,691,117,3112,2
201810,마포구,630,644,651,240,681,99,2945,2
201810,서대문구,550,594,713,641,695,105,3298,3
201810,서초구,367,370,309,151,323,75,1595,1
201810,성동구,575,595,592,123,618,96,2599,2
201810,성북구,923,931,1031,277,967,179,4308,4
201810,송파구,803,690,670,219,689,138,3209,2
201810,양천구,818,803,826,230,879,134,3690,3
201810,영등포구,805,732,728,189,685,115,3254,2
201810,용산구,600,543,518,155,530,85,2431,2
201810,은평구,1350,1415,1371,431,1396,218,6181,6
201810,종로구,423,426,414,36,347,83,1729,1
201810,중구,447,392,393,104,388,69,1793,1
201810,중랑구,1255,1228,1165,350,1252,250,5500,5
201811,강남구,1009,987,860,271,778,159,4064,3
201811,강동구,774,703,749,241,787,163,3417,3
201811,강북구,1231,1280,1358,312,1266,199,5646,5
201811,강서구,1789,1738,1834,394,1928,346,8029,8
201811,관악구,1069,1148,1179,328,1247,221,5192,5
201811,광진구,652,601,557,172,629,106,2717,2
201811,구로구,661,726,750,266,801,121,3325,3
201811,금천구,751,748,832,209,796,124,3460,3
201811,노원구,1967,1966,2217,540,2132,355,9177,9
201811,도봉구,694,766,833,219,951,187,3650,3
201811,동대문구,1135,1061,1156,167,1062,150,4731,4
201811,동작구,681,755,780,262,757,133,3368,3
201811,마포구,655,686,698,244,712,105,3100,2
201811,서대문구,600,621,728,680,733,113,3475,3
201811,서초구,399,399,350,161,365,92,1766,1
201811,성동구,613,625,626,124,682,107,2777,2
201811,성북구,957,952,1073,277,1029,187,4475,4
201811,송파구,843,748,732,268,774,156,3521,3
201811,양천구,862,853,888,238,944,140,3925,3
201811,영등포구,831,763,777,189,728,122,3410,3
201811,용산구,623,569,539,155,558,86,2530,2
201811,은평구,1453,1513,1488,477,1549,247,6727,6
201811,종로구,426,422,423,37,356,85,1749,1
201811,중구,461,396,400,108,404,68,1837,1
201811,중랑구,1316,1291,1211,361,1291,260,5730,5
201812,강남구,1032,1016,899,261,817,170,4195,3
201812,강동구,811,722,772,243,819,169,3536,3
201812,강북구,1259,1313,1365,315,1295,208,5755,5
201812,강서구,1842,1785,1873,409,2012,360,8281,8
201812,관악구,1092,1182,1205,334,1283,233,5329,5
201812,광진구,667,614,566,170,651,106,2774,2
201812,구로구,670,735,768,264,831,129,3397,3
201812,금천구,787,770,858,214,843,128,3600,3
201812,노원구,1992,2028,2263,529,2184,359,9355,9
201812,도봉구,726,774,858,206,989,194,3747,3
201812,동대문구,1165,1084,1192,172,1104,156,4873,4
201812,동작구,716,798,817,266,838,137,3572,3
201812,마포구,667,726,717,247,739,106,3202,2
201812,서대문구,610,639,739,680,761,114,3543,3
201812,서초구,419,426,375,163,398,105,1886,1
201812,성동구,633,641,635,128,721,112,2870,2
201812,성북구,992,989,1102,286,1096,196,4661,4
201812,송파구,883,791,755,288,839,179,3735,3
201812,양천구,899,884,935,246,1000,147,4111,3
201812,영등포구,837,785,778,186,742,125,3453,3
201812,용산구,637,589,544,156,568,86,2580,2
201812,은평구,1491,1578,1543,481,1611,259,6963,6
201812,종로구,440,424,432,38,360,80,1774,1
201812,중구,461,407,403,107,407,71,1856,1
201812,중랑구,1342,1318,1219,364,1328,262,5833,5
201901,강남구,1051,1038,927,280,833,173,4302,4
201901,강동구,819,740,787,242,849,173,3610,3
201901,강북구,1303,1323,1395,314,1322,207,5864,5
201901,강서구,1895,1834,1898,423,2062,362,8474,8
201901,관악구,1124,1195,1227,337,1310,241,5434,5
201901,광진구,679,626,571,171,665,110,2822,2
201901,구로구,690,759,782,259,867,135,3492,3
201901,금천구,800,785,882,217,863,131,3678,3
201901,노원구,2019,2047,2294,540,2232,371,9503,9
201901,도봉구,756,784,873,204,1011,192,3820,3
201901,동대문구,1199,1105,1211,180,1121,165,4981,4
201901,동작구,741,845,840,272,891,148,3737,3
201901,마포구,670,738,725,257,755,108,3253,2
201901,서대문구,623,641,753,642,791,114,3564,3
201901,서초구,434,436,375,167,418,108,1938,1
201901,성동구,636,664,645,123,734,120,2922,2
201901,성북구,1016,1010,1109,285,1138,204,4762,4
201901,송파구,908,821,762,300,874,196,3861,3
201901,양천구,912,906,953,250,1039,151,4211,4
201901,영등포구,849,795,785,187,762,129,3507,3
201901,용산구,635,595,549,158,573,87,2597,2
201901,은평구,1522,1581,1557,457,1628,268,7013,6
201901,종로구,438,431,434,74,367,79,1823,1
201901,중구,476,410,402,104,416,71,1879,1
201901,중랑구,1385,1352,1248,361,1349,269,5964,5
201902,강남구,1082,1055,921,280,862,170,4370,4
201902,강동구,830,752,794,239,862,180,3657,3
201902,강북구,1312,1356,1420,311,1348,216,5963,5
201902,강서구,1928,1839,1905,426,2089,374,8561,8
201902,관악구,1141,1210,1233,329,1346,242,5501,5
201902,광진구,687,630,596,169,666,112,2860,2
201902,구로구,709,768,798,255,898,141,3569,3
201902,금천구,803,794,890,220,881,131,3719,3
201902,노원구,2037,2078,2318,539,2277,379,9628,9
201902,도봉구,764,796,889,207,1041,192,3889,3
201902,동대문구,1217,1119,1216,178,1141,171,5042,4
201902,동작구,740,872,858,278,925,155,3828,3
201902,마포구,671,760,736,260,779,111,3317,3
201902,서대문구,636,657,769,609,809,123,3603,3
201902,서초구,444,438,390,165,434,113,1984,1
201902,성동구,663,672,659,127,746,122,2989,2
201902,성북구,1025,1023,1120,287,1157,213,4825,4
201902,송파구,920,844,774,311,902,200,3951,3
201902,양천구,922,940,962,258,1069,156,4307,4
201902,영등포구,870,800,793,192,779,133,3567,3
201902,용산구,648,604,556,161,589,86,2644,2
201902,은평구,1544,1600,1575,449,1660,274,7102,7
201902,종로구,454,438,433,73,374,79,1851,1
201902,중구,486,417,412,104,421,72,1912,1
201902,중랑구,1415,1366,1264,374,1387,272,6078,5
201903,강남구,1102,1070,929,284,892,172,4449,4
201903,강동구,842,765,802,238,875,184,3706,3
201903,강북구,1331,1378,1450,327,1378,219,6083,5
201903,강서구,1953,1866,1917,431,2123,389,8679,8
201903,관악구,1149,1217,1244,328,1377,254,5569,5
201903,광진구,692,648,593,178,680,117,2908,2
201903,구로구,730,772,819,264,910,145,3640,3
201903,금천구,827,799,882,220,904,133,3765,3
201903,노원구,2092,2097,2359,551,2321,380,9800,9
201903,도봉구,771,799,894,203,1059,202,3928,3
201903,동대문구,1240,1119,1227,178,1155,173,5092,4
201903,동작구,769,883,867,282,938,158,3897,3
201903,마포구,680,760,745,250,795,115,3345,3
201903,서대문구,647,661,783,624,822,126,3663,3
201903,서초구,449,453,398,169,442,113,2024,1
201903,성동구,657,675,674,123,762,127,3018,2
201903,성북구,1035,1039,1139,288,1182,214,4897,4
201903,송파구,925,880,783,314,927,202,4031,3
201903,양천구,948,953,994,265,1104,164,4428,4
201903,영등포구,880,808,796,196,800,140,3620,3
201903,용산구,646,611,555,161,598,93,2664,2
201903,은평구,1553,1641,1584,459,1684,282,7203,7
201903,종로구,465,436,432,73,377,82,1865,1
201903,중구,497,418,420,107,427,73,1942,1
201903,중랑구,1458,1399,1292,391,1428,277,6245,6
201904,강남구,1135,1095,958,288,906,181,4563,4
201904,강동구,870,776,821,246,892,191,3796,3
201904,강북구,1358,1400,1467,340,1394,223,6182,6
201904,강서구,1988,1907,1953,441,2171,402,8862,8
201904,관악구,1196,1223,1268,342,1406,262,5697,5
201904,광진구,708,650,597,209,695,114,2973,2
201904,구로구,745,781,830,277,941,141,3715,3
201904,금천구,825,805,912,229,916,135,3822,3
201904,노원구,2136,2102,2404,583,2350,387,9962,10
201904,도봉구,784,806,900,219,1073,206,3988,3
201904,동대문구,1254,1150,1244,190,1185,173,5196,5
201904,동작구,776,896,887,296,954,160,3969,3
201904,마포구,706,763,751,257,814,115,3406,3
201904,서대문구,658,677,784,613,853,132,3717,3
201904,서초구,472,464,408,179,449,116,2088,1
201904,성동구,676,663,690,137,786,128,3080,2
201904,성북구,1054,1035,1174,297,1189,228,4977,4
201904,송파구,935,886,820,316,943,212,4112,3
201904,양천구,993,981,1036,269,1155,171,4605,4
201904,영등포구,901,802,800,209,804,136,3652,3
201904,용산구,668,612,562,164,610,94,2710,2
201904,은평구,1563,1671,1599,474,1723,295,7325,7
201904,종로구,476,427,437,72,382,84,1878,1
201904,중구,510,420,423,110,441,74,1978,1
201904,중랑구,1552,1481,1391,433,1549,298,6704,6
201905,강남구,1162,1113,982,297,927,182,4663,4
201905,강동구,896,798,830,265,912,198,3899,3
201905,강북구,1371,1415,1485,357,1410,228,6266,6
201905,강서구,2013,1940,1975,447,2190,412,8977,9
201905,관악구,1208,1232,1283,360,1426,266,5775,5
201905,광진구,721,655,619,221,705,118,3039,2
201905,구로구,752,791,838,284,940,145,3750,3
201905,금천구,836,821,909,238,936,133,3873,3
201905,노원구,2159,2134,2440,608,2407,390,10138,10
201905,도봉구,796,817,901,232,1086,209,4041,3
201905,동대문구,1276,1154,1257,191,1204,177,5259,5
201905,동작구,784,910,895,303,968,170,4030,3
201905,마포구,724,779,763,265,827,118,3476,3
201905,서대문구,674,696,792,614,867,132,3775,3
201905,서초구,490,469,407,186,457,118,2127,1
201905,성동구,684,678,702,149,792,128,3133,2
201905,성북구,1058,1026,1176,318,1206,227,5011,4
201905,송파구,971,896,838,320,957,214,4196,3
201905,양천구,1004,991,1054,278,1190,172,4689,4
201905,영등포구,906,804,805,215,816,137,3683,3
201905,용산구,669,617,569,171,608,93,2727,2
201905,은평구,1601,1681,1618,481,1758,302,7441,7
201905,종로구,485,435,428,79,385,86,1898,1
201905,중구,518,425,426,113,446,76,2004,1
201905,중랑구,1616,1523,1455,452,1615,311,6972,6
201906,강남구,1169,1116,999,284,938,180,4686,4
201906,강동구,916,800,839,270,928,196,3949,3
201906,강북구,1404,1438,1499,358,1433,232,6364,6
201906,강서구,2051,1961,1987,458,2223,413,9093,9
201906,관악구,1260,1239,1286,361,1428,271,5845,5
201906,광진구,728,656,644,207,705,120,3060,2
201906,구로구,772,806,853,288,951,151,3821,3
201906,금천구,852,830,917,244,950,136,3929,3
201906,노원구,2202,2153,2445,600,2452,389,10241,10
201906,도봉구,815,824,911,232,1095,210,4087,3
201906,동대문구,1277,1173,1264,192,1218,176,5300,5
201906,동작구,800,920,898,297,981,171,4067,3
201906,마포구,732,787,773,270,846,122,3530,3
201906,서대문구,684,694,795,619,874,134,3800,3
201906,서초구,503,473,405,181,461,118,2141,1
201906,성동구,691,680,710,152,795,128,3156,2
201906,성북구,1079,1040,1193,310,1209,229,5060,4
201906,송파구,993,922,838,321,963,218,4255,4
201906,양천구,1045,1005,1064,275,1210,179,4778,4
201906,영등포구,916,828,816,219,823,142,3744,3
201906,용산구,684,625,575,169,617,94,2764,2
201906,은평구,1630,1694,1629,481,1780,303,7517,7
201906,종로구,489,429,432,77,391,86,1904,1
201906,중구,528,435,428,110,446,77,2024,1
201906,중랑구,1636,1528,1479,442,1633,314,7032,7
201907,강남구,1173,1152,1019,319,950,182,4795,4
201907,강동구,922,819,841,268,945,200,3995,3
201907,강북구,1407,1467,1507,351,1446,234,6412,6
201907,강서구,2076,1990,2014,453,2246,422,9201,9
201907,관악구,1270,1266,1313,361,1440,274,5924,5
201907,광진구,749,675,648,210,708,122,3112,2
201907,구로구,777,834,859,301,969,150,3890,3
201907,금천구,846,857,929,240,974,141,3987,3
201907,노원구,2203,2190,2468,585,2475,392,10313,10
201907,도봉구,813,831,921,226,1105,211,4107,3
201907,동대문구,1286,1189,1267,188,1230,179,5339,5
201907,동작구,811,926,909,298,1005,171,4120,3
201907,마포구,722,797,771,255,852,125,3522,3
201907,서대문구,698,701,800,623,884,133,3839,3
201907,서초구,506,482,407,179,463,119,2156,1
201907,성동구,690,697,706,154,801,125,3173,2
201907,성북구,1078,1058,1191,306,1224,228,5085,4
201907,송파구,1001,943,848,319,969,222,4302,4
201907,양천구,1050,1013,1079,279,1230,180,4831,4
201907,영등포구,920,833,818,213,830,144,3758,3
201907,용산구,695,625,585,165,625,99,2794,2
201907,은평구,1647,1720,1640,472,1810,309,7598,7
201907,종로구,497,431,428,73,393,86,1908,1
201907,중구,520,442,421,107,455,78,2023,1
201907,중랑구,1655,1539,1492,438,1635,325,7084,7
201908,강남구,1188,1164,1028,320,957,186,4843,4
201908,강동구,929,818,855,269,951,195,4017,3
201908,강북구,1427,1479,1527,354,1467,232,6486,6
201908,강서구,2088,2002,2027,458,2248,420,9243,9
201908,관악구,1277,1282,1323,367,1442,268,5959,5
201908,광진구,761,681,654,205,705,122,3128,2
201908,구로구,795,844,871,312,983,150,3955,3
201908,금천구,850,873,937,238,982,143,4023,3
201908,노원구,2219,2217,2477,592,2476,388,10369,10
201908,도봉구,819,842,928,231,1108,210,4138,3
201908,동대문구,1294,1194,1270,188,1227,176,5349,5
201908,동작구,830,926,914,294,1008,171,4143,3
201908,마포구,733,809,767,253,860,125,3547,3
201908,서대문구,704,700,798,611,887,131,3831,3
201908,서초구,506,479,401,181,462,117,2146,1
201908,성동구,696,702,706,155,802,122,3183,2
201908,성북구,1095,1072,1205,312,1233,228,5145,4
201908,송파구,1008,957,864,332,982,218,4361,4
201908,양천구,1062,1024,1082,283,1230,178,4859,4
201908,영등포구,930,838,825,221,827,143,3784,3
201908,용산구,700,628,591,166,625,99,2809,2
201908,은평구,1668,1735,1647,474,1822,306,7652,7
201908,종로구,501,432,431,74,389,83,1910,1
201908,중구,526,443,423,105,451,77,2025,1
201908,중랑구,1662,1567,1503,449,1642,317,7140,7
201909,강남구,1193,1185,1042,312,971,183,4886,4
201909,강동구,928,850,872,258,973,202,4083,3
201909,강북구,1446,1475,1568,344,1506,241,6580,6
201909,강서구,2126,2000,2053,444,2294,439,9356,9
201909,관악구,1300,1299,1327,345,1474,279,6024,5
201909,광진구,767,685,663,189,715,126,3145,2
201909,구로구,789,867,888,315,1013,154,4026,3
201909,금천구,861,876,957,231,998,147,4070,3
201909,노원구,2220,2239,2496,567,2544,399,10465,10
201909,도봉구,825,854,931,221,1122,221,4174,3
201909,동대문구,1303,1213,1270,178,1234,184,5382,5
201909,동작구,839,917,933,290,1042,181,4202,3
201909,마포구,745,808,771,247,886,132,3589,3
201909,서대문구,719,716,788,595,916,135,3869,3
201909,서초구,506,483,406,170,466,119,2150,1
201909,성동구,694,707,705,151,824,124,3205,2
201909,성북구,1108,1083,1190,296,1262,245,5184,5
201909,송파구,1015,978,885,320,1009,230,4437,4
201909,양천구,1077,1030,1091,269,1278,182,4927,4
201909,영등포구,914,862,820,216,843,143,3798,3
201909,용산구,698,643,587,155,640,100,2823,2
201909,은평구,1666,1741,1674,460,1861,311,7713,7
201909,종로구,504,426,435,68,397,85,1915,1
201909,중구,528,457,426,98,462,77,2048,1
201909,중랑구,1661,1566,1516,416,1690,331,7180,7
201910,강남구,1209,1203,1074,309,987,184,4966,4
201910,강동구,941,870,881,260,988,201,4141,3
201910,강북구,1475,1490,1585,325,1553,245,6673,6
201910,강서구,2163,2022,2066,444,2321,442,9458,9
201910,관악구,1335,1305,1336,348,1493,274,6091,6
201910,광진구,789,688,675,187,716,132,3187,2
201910,구로구,804,896,899,318,1038,154,4109,3
201910,금천구,862,893,958,225,1015,149,4102,3
201910,노원구,2261,2265,2509,556,2579,405,10575,10
201910,도봉구,833,859,938,216,1126,225,4197,3
201910,동대문구,1316,1221,1274,178,1247,187,5423,5
201910,동작구,860,921,948,286,1056,183,4254,4
201910,마포구,761,809,784,241,898,134,3627,3
201910,서대문구,728,724,797,596,939,133,3917,3
201910,서초구,501,486,409,157,474,121,2148,1
201910,성동구,709,716,711,152,829,124,3241,2
201910,성북구,1133,1085,1184,284,1289,248,5223,5
201910,송파구,1025,997,894,314,1011,239,4480,4
201910,양천구,1097,1042,1092,266,1320,187,5004,4
201910,영등포구,941,877,824,220,853,150,3865,3
201910,용산구,705,637,595,155,645,100,2837,2
201910,은평구,1665,1748,1662,449,1870,313,7707,7
201910,종로구,506,432,435,72,399,83,1927,1
201910,중구,542,464,432,99,467,76,2080,1
201910,중랑구,1687,1580,1526,409,1715,338,7255,7
201911,강남구,1229,1211,1087,291,994,188,5000,4
201911,강동구,971,878,899,265,1001,205,4219,4
201911,강북구,1507,1498,1625,325,1577,253,6785,6
201911,강서구,2226,2051,2087,456,2362,448,9630,9
201911,관악구,1381,1333,1360,350,1529,293,6246,6
201911,광진구,801,698,684,181,734,136,3234,2
201911,구로구,817,910,911,319,1041,161,4159,3
201911,금천구,877,906,961,236,1018,148,4146,3
201911,노원구,2297,2302,2530,542,2638,413,10722,10
201911,도봉구,855,876,945,217,1139,227,4259,4
201911,동대문구,1337,1228,1283,177,1261,188,5474,5
201911,동작구,873,950,946,289,1084,188,4330,4
201911,마포구,779,815,798,250,917,132,3691,3
201911,서대문구,745,732,805,596,948,133,3959,3
201911,서초구,516,493,413,155,486,123,2186,1
201911,성동구,728,720,720,152,831,125,3276,3
201911,성북구,1153,1092,1183,284,1319,251,5282,5
201911,송파구,1049,1017,900,320,1042,240,4568,4
201911,양천구,1123,1063,1092,261,1350,191,5080,4
201911,영등포구,978,883,842,216,865,162,3946,3
201911,용산구,705,643,597,153,651,100,2849,2
201911,은평구,1696,1763,1676,440,1912,324,7811,7
201911,종로구,516,431,433,71,408,84,1943,1
201911,중구,548,476,426,99,470,79,2098,1
201911,중랑구,1725,1595,1523,414,1737,349,7343,7
201912,강남구,1248,1233,1100,283,1013,196,5073,4
201912,강동구,993,897,888,268,1046,215,4307,4
201912,강북구,1530,1527,1631,310,1600,256,6854,6
201912,강서구,2250,2055,2104,463,2402,459,9733,9
201912,관악구,1411,1373,1395,341,1555,295,6370,6
201912,광진구,816,695,687,174,741,137,3250,2
201912,구로구,822,916,910,326,1072,167,4213,4
201912,금천구,891,906,961,238,1033,152,4181,3
201912,노원구,2304,2342,2530,530,2666,421,10793,10
201912,도봉구,873,878,950,216,1154,235,4306,4
201912,동대문구,1346,1247,1275,173,1264,191,5496,5
201912,동작구,884,963,951,283,1103,189,4373,4
201912,마포구,786,812,806,233,924,133,3694,3
201912,서대문구,755,736,811,571,960,140,3973,3
201912,서초구,531,496,420,155,490,125,2217,1
201912,성동구,740,732,734,147,851,130,3334,3
201912,성북구,1162,1103,1180,280,1347,258,5330,5
201912,송파구,1081,1029,898,313,1060,248,4629,4
201912,양천구,1128,1081,1095,267,1370,198,5139,4
201912,영등포구,1003,903,853,212,878,160,4009,3
201912,용산구,721,638,607,155,660,102,2883,2
201912,은평구,1711,1780,1675,429,1952,327,7874,7
201912,종로구,521,428,431,73,414,85,1952,1
201912,중구,552,476,430,98,473,79,2108,1
201912,중랑구,1752,1614,1524,413,1766,353,7422,7
